__________MMMMMMM
__________M##TTTM
______MMMMM##TTTM
______M######TTTM
______M##MM##TTTM
______MM#MM##TTTM
_____MMM#MMMMMMMM
_____M#CCC#MM____
_MMMMM##C#C#MMMMM
MM###MC#C###M###M
MG#C##C####C##C#M
MMMMMM#CC#C#MMMMM
_____M#C####M____
_____MMMM#MMM____
________M##M_____
________M##M_____
________M##M_____
________MMMM_____