MMMMMMMMMMMM__
MTT##M#####MMM
MTT##M#C##C##M
MTT##MCMMMM##M
MTT####G#MM##M
MTT##M#M##C#MM
MMMMMM#MMC#C#M
__M#C##C#C#C#M
__M####M#####M
__MMMMMMMMMMMM