_______MMMMM_
_MMMMMMM###MM
MM#M#GMM#CC#M
M####C######M
M##C##MMM###M
MMM#MMMMMCMMM
M#C##MMM#TTM_
M#C#C#C#TTTM_
M####MMMTTTM_
M#CC#M_MTTTM_
M##MMM_MMMMM_
MMMM_________