__MMMMM_
MMM###M_
MTGC##M_
MMM#CTM_
MTMMC#M_
M#M#T#MM
MC#VCCTM
M###T##M
MMMMMMMM