________MMMMM____
________M###MMMMM
________M#MCMM##M
________M#####C#M
MMMMMMMMM#MMM###M
MTTTT##MM#C##CMMM
MTTTT####C#CC#MM_
MTTTT##MMC##C#GM_
MMMMMMMMM##C##MM_
________M#C#C##M_
________MMM#MM#M_
__________M####M_
__________MMMMMM_