________MMMMMMMM_
________M#####GM_
________M#CMC#MM_
________M#C##CM__
________MMC#C#M__
MMMMMMMMM#C#M#MMM
MTTTT##MM#C##C##M
MMTTT####C##C###M
MTTTT##MMMMMMMMMM
MMMMMMMM_________