MMMMMM__MMM_
MTT##M_MMGMM
MTT##MMM###M
MTT#####CC#M
MTT##M#M#C#M
MTTMMM#M#C#M
MMMM#C#MC##M
___M##CM#C#M
___M#C##C##M
___M##MM###M
___MMMMMMMMM