____MMMMM_____________
____M###M_____________
____MC##M_____________
__MMM##CMMM___________
__M##C##C#M___________
MMM#M#MMM#M_____MMMMMM
M###M#MMM#MMMMMMM##TTM
M#C##C#############TTM
MMMMM#MMMM#MGMMMM##TTM
____M######MMM__MMMMMM
____MMMMMMMM__________