__MMMM__________
__M##MMMMMMMMMMM
__M####C###C#C#M
__M#CM#C#M##C##M
__M##C#C##M####M
MMM#CM#M##MMMM#M
MGMC#C#C##MM###M
M####C#MCM###M#M
MM##C####C#C#C#M
_MMMM##MMMMMMMMM
__MMM##MMM______
__M######M______
__M######M______
__MTTTTTTM______
__MTTTTTTM______
__MTTTTTTM______
__MMMMMMMM______