______________MMMMMMMM
______________M##TTTTM
___MMMMMMMMMMMM##TTTTM
___M####M##C#C###TTTTM
___M#CCCMC##C#M##TTTTM
___M##C#####C#M##TTTTM
___M#CC#MC#C#CMMMMMMMM
MMMM##C#M#####M_______
M###M#MMMMMMMMM_______
M####C##MM____________
M#CCMCC#GM____________
M###M###MM____________
MMMMMMMMM_____________